####################
#P###E.###T.....D###
#..#A.#W#.###C###.##
#..#...#.#.1.....##
#I.#2##.#..####...#
#.#W###W#.R.#3#..##
#E.T...#....#..####
#.###...###W.A.....#
####################
