############
#P...C....D#
#..##...W..#
#..I..T..E.#
#..1..2..3.#
#....A.....#
############