##################
#P.#E....#I....D##
#..#...T.#.#C#####
###A##...#.###...#
#.1.2..#W#A..T...#
#2#W##.#.#.##.####
#.....#.#..#....##
#3####.#####W.####
##################
