##############
#P..C.....E..#
#..##.I.T....#
#..1..2..3..D#
#....A....W..#
#.C..T.....W.#
##############
