################
#P..###...###D##
#.I.#T..W.#1#.##
#..#.....#2#####
#.E.###C.###3..#
#.A....T.....W##
################
